11111
1C0P1
10101
1E0C1
1C0C1
11111