11111
1C0P1
10001
1E0C1
100C1
11111