11111
1C0P1
10B01
1E001
10001
111111