11111111
1C000001
10000001
1E000001
100000P1
11111111