11111
10001
10111
1E0C1
1CPC1
11111