11111
1C0P1
10001
1E001
10001
11111